room_num;table_cnt;chair_cnt;bookshelf_cnt ;wardrobe_cnt 
111;1;3;2;0
306;2;2;1;2
332;3;3;4;2
406;2;2;1;2
403;4;4;3;2
402;2;2;2;2
319;3;4;3;1
324;4;4;5;2
228;3;3;2;1
232а;2;2;3;2
302;2;2;0;2
303;4;4;1;3
210;4;4;0;3
421;4;5;2;2
201;4;4;4;2
404;4;4;2;2
118;4;4;1;2
327;4;4;3;2
220;3;3;2;2